                            ________________________
===========================|Rajaa Miyako by Rajaaboy|==============================================================================
                            ¯¯¯¯¯¯¯¯¯¯¯¯¯¯¯¯¯¯¯¯¯¯¯¯           
Website - www.justnopoint.com/RajaaBoy/

Released: 6/22/11
Updated:  6/22/11
Version:  2.0

*Only for Mugen 1.0*

=======================| Thanks to |=======================

- RajaaBoy: I need to thank myself once in a while. O_O
- DreamSlayer/Just No Point : Webspace and stuff. =P
- Cyanide: Because he put me through boot camp (and the docs) to learn coding
- Drex: Provided Me with Knowledge to produce My Own Resources.
- Laquak: Even if he didn't do anything, he did something.
- Dshzinetz: He Didn't do anything.=O
- Cybaster: Because every character would be Crap without his Feedback. Plus, I'm using his Readme he kindly made out of nowhere for me. XD
- CrazyKoopa: Used his hitsparks as a base for mine.
- Mauve: Frame display tool, which I used.
- Elecbyte
- Typemoon
- Everyone Else in the mugen community that assisted me.

===============| Unique |=================

- New FX

- New Sprites

- A Portrait with Miyako's original colors is included in the .sff file.

===============| Movelist - Legend |===============

x    = Weak Punch
y    = Medium Punch
z    = Strong Punch
a    = Weak Kick
b    = Medium Kick
c    = Strong Kick

U    = Up
D    = Down
F    = Forward
B    = Back

P    = Any Punch
K    = Any Kick

QCF  = Quarter Circle Forward
QCB  = Quarter Circle Back
HCF  = Half Circle Forward
HCB  = Half Circle Back

DPM  = Forward, Down, Forward (Dragon Punch motion, you know shoryuken? =[ ...Ryu..Ken...)
DPMB = Back, Down, Back (Dragon punch motion backwards)

B->F = Hold back then press forward
D->U = Hold down then press up

PPP  = Repeatedly Press Punch buttons
KKK  = Repeatedly Press Kick buttons

===============| Movelist |===============

<<<< SPECIALS >>>>

- Elbow Bash      = F+b    ; Dash fwd and elbow your opponent! they'll never expect this from a small girl!!

- Body Bash       = F+c    ; Hold for more power. Duck under any attack and smash your body into your opponent.

- Step Punch      = F+y    ; Hold for more power. Step forward and Punch. Looks cool.

- Mantis Strike   = F+z    ; Step forward and Punch with two hands. 

- Sumo Pursuit    = B+z    ; Hold for more power. Step back and then plunge forward. Can guard one basic attack.

- Head Hop        = D+c    ; Hop on somebody's head. Miyako is very rude. ;)

- Choushinchuu    = QCF+P  ; Smooth grooving. Get up close and personal with this quick dash attack.

- Renkantai       = DPM+K  ; Can be done in the air. Do a double kick to those pesky opponents who like the air. Magical invulnerabilitly during start up.

- Shinkyaku       = QCB+K  ; Miyako doesn't like bugs, so be sure to stomp them when you see them... stomp them so hard that you cause an earthquake!!

- Senshippo       = QCB+P  ; Eat an attack and punch your opponent while watching wierd green stuff appear!!

- Elbow Naiyo     = DPMB+P ; Can be done in the air. Jump and elbow smash your opponent in the air. Jump over hadouken.

- Baji Quan Kyaku = QCF+K  ; Can be done in the air. Flying dragon kick with weird green stuff.

<<<< SUPERS >>>>

*Each Super special has up to 3 Levels, unless specified otherwise*

- Baji Quan Blitz           = QCF*2+P ; Secret arts of the fist.

- Kyuukyoku Ougi            = QCB*2+K ; Easier to do than it is to pronounce, magic green stuff that does damage.

- Zetsugi Raikyoku Anhouken = QCB*2+P ; Faaaalccooonn!!!! POOONNCCH!!!

===============| System Moves |=================

- Run                = FF

- Back-dash          = BB

- Roll               = x+a+F or x+a+B

- Dodge              = x+a

- Recovery           = x+a (When you're hit and falling and recovering is possible).

- Throw              = F+c or F+z/B+c or B+z 

- Power-Charge       = y+b

- Parry              = Fwd for Standing/Airbourne Attacks || Dwn for Crouching Attacks.

- Guard Counter      = y+b+F when hit while guarding. Needs at least one power bar.

- C-Groove Canceling = Can only be done with supers that have 3 levels. If the opponent is hit with the level 2 version of the given super, cancel that super into a special attack, or another super attack if there's enough power remaining.

- Charge Attacks     = for some normal attacks, hold the button for more damage/chip damage.

===============| Vigor Mode |=================

*Vigormode is activated by pressing Z and C simutaneously (Z+C). At least one level of power is needed to activate vigormode*

- Palette transformation; Vigorbar position at the lowest part of the screen.

- Attack +10%

- No airguard

- Normal-attack chaining is enabled.

- Vigormoves are available by doing hard versions of certain special-attacks. Vigormoves are more advantageous moves.

- Only level one supers can be activated. Supers cannot be activated when the vigorbar is blinking.

- All attacks prevent recovering for fallen opponents.

- The ability to powercharge and guardcounter are disabled during vigormode.

- Vigormode can be exited at anytime, but only a portion of the power spent will be recovered.